###########
#.....#.E.#
#.###.#.#L#
#.#L#.#.###
#...#@..E.#
#########.#
#.........#
#.#.#.#.###
###.#.#.#L#
#.....#.E.#
##X########